111111111111111111111
100100000010000100C11
1001C0000010000100001
100011100C000C0000111
10C11100000C000011111
100010P00000C11000001
11100000C000000000001
1P0000111111111111111
111111111111111111111
