1111111111111111111111111111111111111111111111111111111111
100000000000000C00000C000000000001111111111111111111111111
1100010000100001000010000000101011111111111111111111111111
1010010000001010001001000000101011111111111111111111111111
1P0000000C00C0000000000000000000C1111111111111111111111111
100010000000000C000001000100100011111111111111111111111111
100000000C000100010000000000000001111111111111111111111111
10010001000000000000000C0000000011111111111111111111111111
10000000000000C1010000010000000011111111111111111111111111
1100000111000001E1000000000C100001111111111111111111111111
1111111111111111111111111111111111111111111111111111111111
