111111111111111111111111111111111111111111111111111111111111111111111111111111111111111111111111
10C000000000000C000000C000000000000C0000C000000000000C000000C000000000000C0000C000000000000C0001
10100101001000001000C000000000000C000000C000000000000C0000C000000000000C000000C000000000000C0001
10100100101010100000C000000000000C000000C000000000000C0000C000000000000C000000C000000000000C0001
10100101001000001000C000000000000C000000C000000000000C0000C000000000000C000000C000000000000C0001
10100C0001E100100000C000000000000C000000C000000000000C0000C000000000000C000000C000000000000C0001
1010010101C100001000C000000000000C000000C000000000000C0000C000000000000C000000C000000000000C0001
10100100110110100000C000000000000C000000C000000000000C0000C000000000000C000000C000000000000C0001
101001100CC000001000C000000000000C000000C000000000000C0000C000000000000C000000C000000000000C0001
10100100101010100000C000000000000C000000C000000000000C0000C000000000000C000000C000000000000C0001
10100101001000001000C000000000000C000000C000000000000C0000C000000000000C000000C000000000000C0001
1110010000C0C0100000C000000000000C000000C000000000000C0000C000000000000C000000C000000000000C0001
1P00101C0000C0000000C000000000000C000000C000000000000C0000C000000000000C000000C000000000000C0001
111111111111111111111111111111111111111111111111111111111111111111111111111111111111111111111111
