11111111111111111111111
1P00000E000C00C00000001
11111111111111111111111
