11111111111111111111
1EC000000000000C0001
10100101001000001001
10100100101010100001
1P00000C0000C0000001
11111111111111111111
