11111111111111111111
10C000000000000C0001
10100101001000001001
10100100101010100001
10100101000000001001
10100C0010E010100001
1010010100C000001001
1010010010CC10100001
101001100CC000001001
10100100101010100001
10100101001000001001
1010010010C0C0100001
1P00000C0000C0000001
11111111111111111111
