11111111111111111111
10C000000000000C0001
10100101001000001001
10100100101010100001
10100101001000001001
10100C0000E000100001
1010010101C100001001
10100100110110100001
101001100CC000001001
10100100101010100001
10100101001000001001
1110010000C0C0100001
1P00101C0000C0000001
11111111111111111111
