11111111111111111111111
1E0000000000C0C00000001
10100001000001010010101
1P00C0000C00000000000C1
11111111111111111111111
