11111111111111111111111
1E0000000001C1C00000001
11100001000011010010101
1P00C0000C00000000000C1
11111111111111111111111
